+++++++++++++++++++++++++++++++
+####################^###^####E
+#####^##########^############+
+###########################^#+
+###^^^#############^######^##+
+##########^##################+
+#############+++#############+
+####^########+++#####^####^##+
+#############+++#############+
+#############^###############+
+######^############^##^######+
+R##^####################^####+
+++++++++++++++++++++++++++++++